000000000000101101000000000000
011110111101101101101111011110
011110111100101101001111011110
000000000000000000000000000000
011110100001111111100001011110
000000100000001100000001000000
011010111110101101011111010110
010010100000101101000001010010
011110000111100001111000011110
000000000000000000000000000000
011100000011100001110000001110
010000011000100001000110000010
010000010000000000000010000010
010111010000100001000010111010
000000000110001100011000000000
000000000110001100011000000000
010111010000100001000010111010
010000010000000000000010000010
010000011000100001000110000010
011100000011101101110000001110
000000000000001100000000000000
011110000111101101111000011110
010010100000100001000001010010
011010111110100001011111010110
000000100000000000000001000000
011110100001111111100001011110
000000000000000000000000000000
011110111100101101001111011110
011110111101101101101111011110
000000000000101101000000000000