111111111111111111111111111111
100011000000111000000111001010
100001000100101010010101011110
111000100101010101001101100101
110011000000010000001000000001
100000000000111111111111110001
100000101000000010000000000011
110000000100000001000000000011
100011010101010101110111011101
100011111111111110000001111111
100000000000000000000011111111
100010000000111011100000000001
100000000000000000000000000001
111110000000000000001111111101
100000000001110000000000000001
100000000000000000000000001111
100000000000011111111111100101
100101010010101001010101010101
100000000001110000001100000001
100000000000000111010100101101
100000000000000000000001000001
100000000000000001010101001011
100001100000000001000000011001
111000000000000110100101010011
100000000000010101010101111111
100001100101111110000000000001
100000000000000000000111111111
111000000000000000000000000001
100000000000111111111111111001
111111111111111111111111111111